8 12
+-+-+-+-+-+-+-+-+-+-+-+-+
|S                      |
+ + + + + + + + + + + + +
|                       |
+ + + + + + + + + + + + +
|                       |
+ + + + + + + + + + + + +
|                       |
+ + + + + + + + + + + + +
|                       |
+ + + + + + + + + + + + +
|                       |
+ + + + + + + + + + + + +
|                       |
+ + + + + + + + + + + + +
|                      E|
+-+-+-+-+-+-+-+-+-+-+-+-+

