8 10
+-+-+-+-+-+-+-+-+-+  
|                 |  
+ +-+-+-+ +-+-+-+ +  
| |             | |  
+ + +-+-+-+-+-+ + +  
| | |         | | |  
+ + + +-+-+-+ + + +-+
| | | |     | | |  S|
+ + + + +-+ + + + +-+
| |   |   |E| | | |  
+ + + +-+ +-+ + + +  
| | |         | | |  
+ + +-+-+-+-+-+ + +  
| |             | |  
+ +-+-+-+-+-+-+-+ +  
|                 |  
+-+-+-+-+-+-+-+-+-+  
